R 1920 1080
NO ./pics/bluestone.xpm
SO ./pics/greystone.xpm
WE ./pics/redbrick.xpm
EA ./pics/wood.xpm
S ./pics/barrel.xpm
F 0,255,255
C 255,30,255

111111111111111111
120000002001100021
100000002000110001
1000200020002000011111111
11111000W000000001
100020000002000001
100000020001111111
120000001000000021
111111111111111111
